6
+-+-+-+-+-+-+
|     |     |
+ +   +-+   +
| |     |   |
+ +-+   +   +
|   |       |
+-+-+ +-+-+ +
| |  A    | |
+ +-+   +-+ +
|    P V  | |
+ + +-+ + + +
| |T    |H  |
+-+-+-+-+-+-+