10
+-+-+-+-+-+-+-+-+-+-+
|          H|T| |   |
+ +     +   + + + + +
| |     |   | | | | |
+ +   + +-+-+ + + +-+
|     |           | |
+-+ + +     +-+ + +-+
| | |         | |   |
+ + +-+-+ +-+ + + + +
|   | |       |  V| |
+ +-+ +       +-+ + +
|  A              | |
+-+   + +   +-+ + + +
|     |P|       |   |
+   + +-+   +-+ +   +
|   |   |       |   |
+   +   + +-+-+ + +-+
|                 | |
+ +-+   +-+-+   + +-+
|           |   |   |
+-+-+-+-+-+-+-+-+-+-+