10
+-+-+-+-+-+-+-+-+-+-+
|   |  A            |
+ + +   + +         +
| | |   | |         |
+-+ +   + +   +-+ +-+
| |       |   |V  | |
+ + +-+ +-+-+ +   + +
|   |               |
+   +           +-+-+
|   |P              |
+   +     +-+   + + +
|   |           | | |
+ +-+-+ +-+   +-+ + +
| |        T        |
+ +-+     +   +-+   +
|   |     |     |   |
+   + + + +     + +-+
|   | | |         | |
+   + +-+   +-+ +-+-+
|     | |   | |    H|
+-+-+-+-+-+-+-+-+-+-+