10
+-+-+-+-+-+-+-+-+-+-+
|T          |       |
+-+ +-+   + +       +
| |       |         |
+ + +     + + +     +
|   |       | |     |
+   +-+-+   + +     +
|           |       |
+       +   +-+     +
|       |           |
+-+   +-+-+ +-+-+   +
|         |V  | |   |
+         + + + +   +
|    A    | |       |
+-+-+   +-+ + +-+ + +
|                 | |
+ +               + +
| |            H P| |
+ +   +-+ + +-+   + +
| |       |         |
+-+-+-+-+-+-+-+-+-+-+