10
+-+-+-+-+-+-+-+-+-+-+
|                   |
+ + +-+-+   +-+   +-+
| |     |     |     |
+ +-+   +-+   +-+-+ +
|         |         |
+       +-+   +-+   +
|        V|   |T    |
+   +-+   +-+ +   +-+
|   |        A|     |
+-+ + +-+     +-+ +-+
|     |         |   |
+     + +-+     +   +
|       | |     |   |
+       +-+     + + +
|            P    | |
+ +-+   + +-+   + + +
| |     |    H  | | |
+-+-+   +-+     + + +
| | |     |         |
+-+-+-+-+-+-+-+-+-+-+